






11111    111111111

  a      i       a
1111  11111   1111

            a
111111111111111

   a    a      a
1111  11111   1111

    a
  1111   111111

        a
1111111111111111

  a
111   111  1111111

            a
  111111111111

              a
1111        111111

    a
 1111    11111

     a
    111111

          a
  1111   1111

  a           a
111  11111  1111

               a
  1111111111111111


1  1 111 1   111
1  1 1 1 1   1 1
1111 1 1 1   111
1  1 1 1 1   1 1
1  1 111 111 1 1





























111111111111111111111111